97
32
22222222222222222222222222222222
20202200200200220022222222222222
20202200200200220022222222222222
20002002020002022002222222222222
20022000202200200202222200222222
22002002020000000022222222222222
22022020000220022002222222222222
20002000020020022202222222222222
20000002000220000022222222222222
22200200202200002002222002222222
22222200220202002002222022222222
20020220002000222202222202222222
22222222220000002222222222222222
20002002020002022002222222022222
20022000202200200202222200222222
22002002020000000022222222222222
22022020000220022002222222222222
20002000020020022202222222222222
20000002000220000022222222222222
22200200202200002002222002222222
22S22200220202002002222022222222
20020220002000222202222202222222
20022222220000002222222222222222
20202200200200220022222222222222
20002002020002022002222222222222
20022000202200200202222200222222
22002002020000000022222222222222
22022020000220022002222222222222
20002000020020022002222222222222
20000002000220000022222222222222
22200200202200002002222002222222
22222200220200002000022022222222
20020220002000200000222202222222
22222222222222220002222222222222
20202200200200200022222222222222
20002002020000002002222222222222
20022000202200200202222200222222
22002002020000000022222222222222
22022020000220022002222222222222
20002000020020022202222222222222
20000000000200000020000222222222
22200200202200002002222002222222
22222200220202002002222022222222
20020220002000222202222202222222
22222222200000002222222222222222
22222222200222222222222222222222
22222222220222222222222222222222
20202200200200000022222222222222
20202200200200220022222222222222
20002002020002022002222222222222
20022000202200200002222200222222
22002002020000000022222222222222
22022020000220022002222222222222
20002000020020022002222222222222
20000002000220000022222222222222
22200200202200002002222002222222
22222200220202002002222022222222
20020220002000220002222202222222
22222222220000000222222222222222
20002000000002022002222222222222
20022000202200200202222200222222
22002002020000000022222222222222
22022020000220022002222222222222
20002000020020022202222222222222
20000000000220000022222222222222
22200200202200002002222002222202
22222200220202002002222022222222
20020220002000222202222202222222
22222222200000002222222222222222
20202200200200220022200022222222
20002002000002022002222000222222
20022000002200200202222200222222
22002002020000000022222222222222
22022020000220022002222000222222
20002000020020022202222222222222
20000002000220000022222222222222
22000200202200002002222002222222
22022200220202002002222022222222
20020220002000222200002202222222
20200002222222220000222222222222
20202200200200220022222222222222
20002002020002022002222222222222
20022000202200200202222200222222
22002002020000000022222222222222
22022020000220022002222222222222
20002000020020022202222222222222
20000002000220000020000222222222
22000200202200002002222002222222
22022200220202002002222022222222
20020220002000022202222202222222
20222222220000002222222222222222
20000022222222222222222222222222
20222000220202002002222022222222
20000220002000222202222202222222
22202000220000002222222222222222
2220T022222222220000222222222222
22222222222222222222222222222222